2222222222222222222222222
2000100101000011000000002
2020102000220011200021102
2122100020011011002021102
2111100020111020002020002
2000000020200020000000002
2000122111001220121212102
2010001020200020101010102
2011211000111020121212102
2020002000011010000000002
2021112020000010001111002
2001010011021200212000212
2120122120210120101020102
2000000020200010010020012
2222222222222222222222222