MSSSSSSSSSSSSSSSSSSSSSSSO
Q00000010100001100000000R
Q02010222222001122202110R
Q00010002001101100202110R
Q21120002011102000202220R
Q00000002020002000000000R
Q22212211122122012121210R
Q01000102020002010101010R
Q01121102011102012121210R
Q02222202001101000000000R
Q02111202000001000111100R
Q00101001122122221222221R
Q12212212021012010102010R
Q00000002020001001002001R
NTTTTTTTTTTTTTTTTTTTTTTTP